1111111
10000P1
1000001
1000001
100E001
10C0001
1C0C001
1111111